{
  "metadata": {
    "tag": "level_example",
    "title": "Level Example",
    "codeLinesAmount": 15,
    "allowedInstructions": ["MOVE", "ROT", "GOTO", "IF"]
  },
  "tileMap": {
    "name": "",
    "width": 13,
    "height": 13,
    "tiles": [
      [10,10,10,10,10,10,10,10,10,10,10,10,10],
      [10,20,20,20,20,20,20,20,20,20,20,20,10],
      [10,20,10,10,10,10,10,10,10,20,10,20,10],
      [10,20,20,10,20,20,10,20,20,20,10,20,10],
      [10,20,20,10,20,10,10,10,10,20,10,20,10],
      [10,20,10,10,10,20,20,20,10,10,10,20,10],
      [10,20,20,10,10,10,10,10,20,20,20,20,10],
      [10,20,10,10,20,20,20,10,10,10,10,20,10],
      [10,20,10,20,10,20,10,20,20,20,10,20,10],
      [10,20,20,20,10,10,10,10,10,10,10,20,10],
      [10,20,10,10,10,20,20,20,10,20,10,20,10],
      [10,20,20,20,20,20,20,20,20,20,20,20,10],
      [10,10,10,10,10,10,10,10,10,10,10,10,10]
    ],
    "collision": [
      [0,0,0,0,0,0,0,0,0,0,0,0,0],
      [0,1,1,1,1,1,1,1,1,1,1,1,0],
      [0,1,0,0,0,0,0,0,0,1,0,1,0],
      [0,1,1,0,1,1,0,1,1,1,0,1,0],
      [0,1,1,0,1,0,0,0,0,1,0,1,0],
      [0,1,0,0,0,1,1,1,0,0,0,1,0],
      [0,1,1,0,0,0,0,0,1,1,1,1,0],
      [0,1,0,0,1,1,1,0,0,0,0,1,0],
      [0,1,0,1,0,1,0,1,1,1,0,1,0],
      [0,1,1,1,0,0,0,0,0,0,0,1,0],
      [0,1,0,0,0,1,1,1,0,1,0,1,0],
      [0,1,1,1,1,1,1,1,1,1,1,1,0],
      [0,0,0,0,0,0,0,0,0,0,0,0,0]
    ],
    "zones": [
      {
        "id": 30,
        "x": 10,
        "y": 2,
        "type": "start"
      },
      {
        "id": 31,
        "x": 2,
        "y": 10,
        "type": "win"
      }
    ]
  }
}


